"","dia","hora","hora_1","amostras","linha","diferenca"
"1",20191004,32500,32700,1435,205,200
"2",20191004,42700,42900,1435,266,200
"3",20191004,142400,142600,1435,862,200
"4",20191004,235700,235900,1435,1434,200
"5",20191005,10600,10800,1435,66,200
"6",20191005,22400,22600,1435,143,200
"7",20191005,43900,44100,1435,277,200
"8",20191005,73900,74100,1435,456,200
"9",20191013,182900,183100,1438,1109,200
"10",20191014,104800,105000,1414,648,200
"11",20191014,105000,110700,1414,649,5700
"12",20191014,111200,111400,1414,655,200
"13",20191014,111400,111600,1414,656,200
"14",20191014,120800,121000,1414,709,200
"15",20191014,165900,170300,1414,999,4400
"16",20191014,170300,170500,1414,1000,200
"17",20191014,214900,215100,1414,1285,200
"18",20191015,300,500,1373,3,200
"19",20191015,4900,5200,1373,48,300
"20",20191015,30400,30600,1373,181,200
"21",20191015,83400,83600,1373,510,200
"22",20191015,90300,90700,1373,538,400
"23",20191015,91800,92200,1373,550,400
"24",20191015,105500,105700,1373,644,200
"25",20191015,105900,114300,1373,647,8400
"26",20191015,124700,124900,1373,712,200
"27",20191015,133300,133500,1373,757,200
"28",20191015,153700,154100,1373,880,400
"29",20191015,155100,155300,1373,891,200
"30",20191015,160000,160200,1373,899,200
"31",20191015,163600,163800,1373,934,200
"32",20191015,164900,165100,1373,946,200
"33",20191015,210300,210600,1373,1199,300
"34",20191016,400,700,1377,4,300
"35",20191016,94900,95100,1377,587,200
"36",20191016,101000,101200,1377,607,200
"37",20191016,110600,113000,1377,662,2400
"38",20191016,130900,131100,1377,762,200
"39",20191016,152700,152900,1377,899,200
"40",20191016,152900,153100,1377,900,200
"41",20191016,153100,153500,1377,901,400
"42",20191016,155700,160400,1377,924,4700
"43",20191016,164300,164500,1377,964,200
"44",20191016,165300,170000,1377,973,4700
"45",20191016,170900,172000,1377,983,1100
"46",20191016,172200,172900,1377,986,700
"47",20191017,34800,35000,1433,228,200
"48",20191017,75500,75700,1433,474,200
"49",20191017,141800,142000,1433,856,200
"50",20191017,145400,145600,1433,891,200
"51",20191017,152500,152700,1433,921,200
"52",20191017,171900,172100,1433,1034,200
"53",20191018,90300,90500,1423,543,200
"54",20191018,100300,100500,1423,602,200
"55",20191018,100600,100800,1423,604,200
"56",20191018,122300,123100,1423,740,800
"57",20191018,123300,123500,1423,743,200
"58",20191018,130000,130300,1423,769,300
"59",20191018,171900,172100,1423,1026,200
"60",20191018,193400,193600,1423,1160,200
"61",20191018,223400,223600,1423,1339,200
"62",20191023,90300,90500,1426,543,200
"63",20191023,91500,92300,1426,554,800
"64",20191023,115900,120100,1426,711,4200
"65",20191023,192500,192700,1426,1156,200
"66",20191023,193300,193500,1426,1163,200
"67",20191023,231000,231200,1426,1379,200
"68",20191023,231900,232100,1426,1387,200
"69",20191024,30400,30600,1424,184,200
"70",20191024,74500,74700,1424,464,200
"71",20191024,85200,85400,1424,530,200
"72",20191024,94900,95100,1424,586,200
"73",20191024,115900,120100,1424,715,4200
"74",20191024,145200,145400,1424,887,200
"75",20191024,162500,162700,1424,979,200
"76",20191024,171000,171200,1424,1023,200
"77",20191024,193400,193600,1424,1166,200
"78",20191024,200700,200900,1424,1198,200
"79",20191024,201000,201200,1424,1200,200
"80",20191024,205800,210000,1424,1247,4200
"81",20191024,210400,210600,1424,1252,200
"82",20191024,223400,223600,1424,1341,200
"83",20191024,235500,235700,1424,1421,200
"84",20191025,12500,12700,1428,85,200
"85",20191025,34900,35100,1428,228,200
"86",20191025,44500,44900,1428,283,400
"87",20191025,55200,55400,1428,347,200
"88",20191025,73400,73600,1428,448,200
"89",20191025,85500,85700,1428,528,200
"90",20191025,103400,103600,1428,626,200
"91",20191025,115900,120100,1428,710,4200
"92",20191025,184900,185100,1428,1119,200
"93",20191026,34900,35100,1431,229,200
"94",20191026,81900,82100,1431,498,200
"95",20191026,94900,95100,1431,587,200
"96",20191026,115900,120100,1431,716,4200
"97",20191026,154000,154200,1431,936,200
"98",20191026,180400,180600,1431,1079,200
"99",20191026,222500,222700,1431,1339,200
"100",20191026,231900,232100,1431,1392,200
"101",20191027,21000,21200,1430,130,200
"102",20191027,51900,52100,1430,318,200
"103",20191027,85500,85700,1430,533,200
"104",20191027,115900,120100,1430,716,4200
"105",20191027,124900,125100,1430,765,200
"106",20191027,175500,175700,1430,1070,200
"107",20191027,192500,192700,1430,1159,200
"108",20191027,223400,223600,1430,1347,200
"109",20191027,235200,235400,1430,1424,200
"110",20191028,4000,4200,1430,40,200
"111",20191028,111000,111200,1430,669,200
"112",20191028,115900,120100,1430,717,4200
"113",20191028,123700,123900,1430,754,200
"114",20191028,162500,162700,1430,981,200
"115",20191028,175500,175700,1430,1070,200
"116",20191028,192500,192700,1430,1159,200
"117",20191028,201000,201200,1430,1203,200
"118",20191028,223400,223600,1430,1346,200
"119",20191029,60400,60600,1431,364,200
"120",20191029,81900,82100,1431,498,200
"121",20191029,115900,120100,1431,717,4200
"122",20191029,131000,131200,1431,787,200
"123",20191029,172100,172300,1431,1037,200
"124",20191029,185100,185300,1431,1126,200
"125",20191029,202100,202300,1431,1215,200
"126",20191029,232100,232300,1431,1394,200
"127",20191030,13600,13800,1428,96,200
"128",20191030,22100,22300,1428,140,200
"129",20191030,73600,73800,1428,454,200
"130",20191030,82100,82300,1428,498,200
"131",20191030,90600,90800,1428,542,200
"132",20191030,115900,120100,1428,714,4200
"133",20191030,163600,163800,1428,990,200
"134",20191030,172100,172300,1428,1034,200
"135",20191030,210600,210800,1428,1258,200
"136",20191030,223600,223800,1428,1347,200
"137",20191030,232100,232300,1428,1391,200
"138",20191031,30600,30800,1434,186,200
"139",20191031,115900,120100,1434,718,4200
"140",20191031,145900,150100,1434,897,4200
"141",20191031,162900,163100,1434,986,200
"142",20191031,175900,180100,1434,1075,4200
"143",20191101,4400,4600,1430,44,200
"144",20191101,34400,34600,1430,223,200
"145",20191101,55900,60100,1430,357,4200
"146",20191101,115900,120100,1430,716,4200
"147",20191101,132900,133100,1430,805,200
"148",20191101,154400,154600,1430,939,200
"149",20191101,164200,164400,1430,996,200
"150",20191101,174700,175000,1430,1060,300
"151",20191102,52700,52900,1433,327,200
"152",20191102,55900,60100,1433,358,4200
"153",20191102,115900,120100,1433,717,4200
"154",20191102,175900,180100,1433,1076,4200
"155",20191102,184400,184600,1433,1120,200
"156",20191102,194200,194400,1433,1177,200
"157",20191103,61200,61400,1434,372,200
"158",20191103,104200,104400,1434,641,200
"159",20191103,115900,120100,1434,717,4200
"160",20191103,141400,141600,1434,851,200
"161",20191103,214400,214600,1434,1300,200
"162",20191104,4400,4600,1363,44,200
"163",20191104,25900,30100,1363,178,4200
"164",20191104,31200,31400,1363,190,200
"165",20191104,80700,80900,1363,484,200
"166",20191104,81400,81600,1363,490,200
"167",20191104,95700,95900,1363,592,200
"168",20191104,103100,103500,1363,625,400
"169",20191104,104700,110700,1363,638,6000
"170",20191104,115500,115800,1363,687,300
"171",20191104,115900,120100,1363,689,4200
"172",20191104,145900,150100,1363,868,4200
"173",20191104,170900,171100,1363,997,200
"174",20191104,171100,175500,1363,998,4400
"175",20191105,4400,4600,1426,44,200
"176",20191105,44200,44400,1426,281,200
"177",20191105,61200,61400,1426,370,200
"178",20191105,102900,103100,1426,626,200
"179",20191105,104900,105100,1426,645,200
"180",20191105,112700,112900,1426,682,200
"181",20191105,115900,120100,1426,713,4200
"182",20191105,125700,125900,1426,770,200
"183",20191105,133800,134000,1426,810,200
"184",20191105,141400,141600,1426,845,200
"185",20191105,214400,214600,1426,1294,200
"186",20191105,215700,215900,1426,1306,200
"187",20191105,224200,224400,1426,1350,200
"188",20191106,4400,4600,1425,44,200
"189",20191106,21400,21600,1425,133,200
"190",20191106,22700,22900,1425,145,200
"191",20191106,34400,34600,1425,221,200
"192",20191106,51400,51600,1425,310,200
"193",20191106,55900,60100,1425,354,4200
"194",20191106,64400,64600,1425,398,200
"195",20191106,102900,103100,1425,622,200
"196",20191106,111400,111600,1425,666,200
"197",20191106,115900,120100,1425,710,4200
"198",20191106,145900,150100,1425,889,4200
"199",20191106,171400,171600,1425,1023,200
"200",20191106,205900,210100,1425,1247,4200
"201",20191106,231400,231600,1425,1381,200
"202",20191107,22700,22900,1393,147,200
"203",20191107,34400,34600,1393,223,200
"204",20191107,35700,35900,1393,235,200
"205",20191107,51400,51600,1393,311,200
"206",20191107,102900,103100,1393,625,200
"207",20191107,115900,120100,1393,714,4200
"208",20191107,141400,141600,1393,848,200
"209",20191107,145900,150100,1393,892,4200
"210",20191107,154200,161400,1393,934,7200
"211",20191107,161400,161600,1393,935,200
"212",20191107,171400,171700,1393,994,300
"213",20191107,184400,184700,1393,1082,300
"214",20191107,194200,194400,1393,1138,200
"215",20191107,232700,232900,1393,1362,200
"216",20191108,31200,31400,1431,192,200
"217",20191108,81400,81600,1431,493,200
"218",20191108,91200,91400,1431,550,200
"219",20191108,115900,120100,1431,716,4200
"220",20191108,132900,133100,1431,805,200
"221",20191108,151200,151400,1431,907,200
"222",20191108,192900,193100,1431,1163,200
"223",20191108,222900,223100,1431,1342,200
"224",20191109,35700,35900,1425,237,200
"225",20191109,51400,51600,1425,313,200
"226",20191109,52700,52900,1425,325,200
"227",20191109,55900,60100,1425,356,4200
"228",20191109,102900,103200,1425,625,300
"229",20191109,115900,120100,1425,713,4200
"230",20191109,122000,122300,1425,733,300
"231",20191109,132900,133100,1425,800,200
"232",20191109,154400,154600,1425,934,200
"233",20191109,184400,184600,1425,1113,200
"234",20191109,222900,223100,1425,1337,200
"235",20191109,232700,232900,1425,1394,200
"236",20191110,12900,13100,1425,89,200
"237",20191110,25900,30100,1425,178,4200
"238",20191110,31200,31400,1425,190,200
"239",20191110,35700,35900,1425,234,200
"240",20191110,65700,65900,1425,413,200
"241",20191110,82700,82900,1425,502,200
"242",20191110,95700,95900,1425,591,200
"243",20191110,115900,120100,1425,712,4200
"244",20191110,132900,133100,1425,801,200
"245",20191110,162900,163100,1425,980,200
"246",20191110,171400,171600,1425,1024,200
"247",20191110,201400,201600,1425,1203,200
"248",20191110,214400,214600,1425,1292,200
"249",20191110,224200,224400,1425,1349,200
"250",20191111,14200,14400,1425,102,200
"251",20191111,25900,30100,1425,178,4200
"252",20191111,51400,51600,1425,312,200
"253",20191111,72900,73100,1425,446,200
"254",20191111,85900,90100,1425,535,4200
"255",20191111,91200,91400,1425,547,200
"256",20191111,112700,112900,1425,681,200
"257",20191111,115900,120100,1425,712,4200
"258",20191111,121200,121400,1425,724,200
"259",20191111,154400,154600,1425,935,200
"260",20191111,175900,180100,1425,1069,4200
"261",20191111,181200,181400,1425,1081,200
"262",20191111,202700,202900,1425,1215,200
"263",20191111,205900,210100,1425,1246,4200
"264",20191112,55900,60100,1432,359,4200
"265",20191112,85900,90100,1432,538,4200
"266",20191112,115900,120100,1432,717,4200
"267",20191112,132000,132200,1432,797,200
"268",20191112,135000,135200,1432,826,200
"269",20191112,201400,201600,1432,1209,200
"270",20191112,215000,215200,1432,1304,200
"271",20191113,12900,13100,1434,89,200
"272",20191113,14200,14400,1434,101,200
"273",20191113,31200,31400,1434,190,200
"274",20191113,115900,120100,1434,716,4200
"275",20191113,214400,214600,1434,1300,200
"276",20191114,5700,5900,1434,57,200
"277",20191114,25900,30100,1434,178,4200
"278",20191114,51400,51600,1434,312,200
"279",20191114,64400,64600,1434,401,200
"280",20191114,115900,120100,1434,715,4200
"281",20191115,115900,120100,1438,719,4200
"282",20191116,115900,120100,1437,719,4200
"283",20191116,125800,130000,1437,777,4200
"284",20191117,115900,120100,1438,719,4200
"285",20191118,85600,90800,1410,536,5200
"286",20191118,92800,94600,1410,557,1800
"287",20191118,115900,120100,1410,691,4200
"288",20191119,115900,120100,1438,719,4200
"289",20191120,115900,120100,1438,719,4200
"290",20191121,10100,10300,1246,61,200
"291",20191121,115900,120100,1246,718,4200
"292",20191122,110000,110200,1068,295,200
"293",20191122,113600,113800,1068,330,200
"294",20191122,115900,120100,1068,352,4200
"295",20191122,153000,153200,1068,562,200
"296",20191122,165200,165400,1068,643,200
"297",20191122,221500,221700,1068,965,200
"298",20191123,50000,50200,1431,300,200
"299",20191123,75100,75300,1431,470,200
"300",20191123,84500,84700,1431,523,200
"301",20191123,110000,110200,1431,657,200
"302",20191123,115900,120100,1431,715,4200
"303",20191123,204500,204700,1431,1240,200
"304",20191123,213000,213200,1431,1284,200
"305",20191123,230000,230200,1431,1373,200
"306",20191124,50000,50200,1429,300,200
"307",20191124,83600,83800,1429,515,200
"308",20191124,84500,84700,1429,523,200
"309",20191124,110000,110200,1429,657,200
"310",20191124,115900,120100,1429,715,4200
"311",20191124,131500,131700,1429,790,200
"312",20191124,153000,153200,1429,924,200
"313",20191124,161500,161700,1429,968,200
"314",20191124,173700,173900,1429,1049,200
"315",20191124,174500,174700,1429,1056,200
"316",20191125,2100,2300,1433,21,200
"317",20191125,11500,11700,1433,74,200
"318",20191125,41500,41700,1433,253,200
"319",20191125,54500,54700,1433,342,200
"320",20191125,115900,120100,1433,715,4200
"321",20191125,190700,190900,1433,1142,200
"322",20191126,33000,33200,1434,210,200
"323",20191126,92200,92400,1434,561,200
"324",20191126,113600,113800,1434,694,200
"325",20191126,115900,120100,1434,716,4200
"326",20191126,174500,174700,1434,1061,200
"327",20191127,32100,32300,1433,201,200
"328",20191127,41500,41700,1433,254,200
"329",20191127,54500,54700,1433,343,200
"330",20191127,71500,71700,1433,432,200
"331",20191127,115900,120100,1433,715,4200
"332",20191127,204500,204700,1433,1240,200
"333",20191128,15100,15400,1430,111,300
"334",20191128,41500,41700,1430,253,200
"335",20191128,70700,70900,1430,424,200
"336",20191128,115900,120100,1430,715,4200
"337",20191128,122700,122900,1430,742,200
"338",20191128,123000,123200,1430,744,200
"339",20191128,213000,213200,1430,1283,200
"340",20191128,220600,220800,1430,1318,200
"341",20191129,50000,50200,1243,300,200
"342",20191129,94700,102400,1243,586,7700
"343",20191129,102500,103600,1243,588,1100
"344",20191129,105000,111000,1243,603,6000
"345",20191129,111200,111500,1243,606,300
"346",20191129,115900,120100,1243,651,4200
"347",20191129,131500,131700,1243,726,200
"348",20191129,133700,133900,1243,747,200
"349",20191129,143700,144100,1243,806,400
"350",20191129,145500,154100,1243,821,8600
"351",20191129,154100,165500,1243,822,11400
"352",20191129,181800,182000,1243,906,200
"353",20191129,185700,185900,1243,944,200
"354",20191129,194900,195100,1243,995,200
"355",20191129,220300,220500,1243,1128,200
"356",20191130,14800,15000,1094,108,200
"357",20191130,31200,31400,1094,191,200
"358",20191130,44500,44700,1094,283,200
"359",20191130,53300,53500,1094,330,200
"360",20191130,72100,125900,1094,437,53800
"361",20191130,152700,152900,1094,586,200
"362",20191130,161300,161500,1094,631,200
"363",20191130,165800,170000,1094,675,4200
"364",20191130,195800,2e+05,1094,854,4200
"365",20191209,10000,10200,1433,60,200
"366",20191209,42600,42800,1433,265,200
"367",20191209,55600,55800,1433,354,200
"368",20191209,72600,72800,1433,443,200
"369",20191209,111100,111300,1433,667,200
"370",20191209,115900,120100,1433,714,4200
"371",20191219,100200,100400,1432,602,200
"372",20191219,115900,120100,1432,718,4200
"373",20191219,122800,123000,1432,746,200
"374",20191219,135700,135900,1432,834,200
"375",20191219,160200,160400,1432,958,200
"376",20191219,211600,211800,1432,1271,200
"377",20191219,225700,225900,1432,1371,200
"378",20191220,2700,2900,1430,27,200
"379",20191220,10100,10300,1430,60,200
"380",20191220,40200,40400,1430,240,200
"381",20191220,83100,83300,1430,508,200
"382",20191220,115900,120100,1430,715,4200
"383",20191220,122800,123000,1430,743,200
"384",20191220,144200,144500,1430,876,300
"385",20191220,220200,220400,1430,1314,200
"386",20191221,2700,2900,1428,27,200
"387",20191221,15700,15900,1428,116,200
"388",20191221,32700,32900,1428,205,200
"389",20191221,40100,40300,1428,238,200
"390",20191221,83200,83400,1428,508,200
"391",20191221,115900,120100,1428,714,4200
"392",20191221,144200,144400,1428,876,200
"393",20191221,161200,161400,1428,965,200
"394",20191221,204200,204400,1428,1234,200
"395",20191221,221200,221400,1428,1323,200
"396",20191221,234200,234400,1428,1412,200
"397",20191222,24200,24400,1428,162,200
"398",20191222,71200,71400,1428,431,200
"399",20191222,74600,74800,1428,464,200
"400",20191222,84200,84400,1428,519,200
"401",20191222,115900,120100,1428,715,4200
"402",20191222,122700,122900,1428,742,200
"403",20191222,131200,131400,1428,786,200
"404",20191222,134600,134800,1428,819,200
"405",20191222,135700,135900,1428,829,200
"406",20191222,144200,144400,1428,873,200
"407",20191222,151600,151800,1428,906,200
"408",20191223,100100,100300,1434,601,200
"409",20191223,115900,120100,1434,718,4200
"410",20191223,160100,160300,1434,959,200
"411",20191223,164600,164800,1434,1003,200
"412",20191223,182700,182900,1434,1103,200
"413",20191224,10200,10400,1432,62,200
"414",20191224,15700,15900,1432,116,200
"415",20191224,113200,113400,1432,690,200
"416",20191224,115900,120100,1432,716,4200
"417",20191224,144500,144700,1432,881,200
"418",20191224,212700,212900,1432,1282,200
"419",20191224,225800,230000,1432,1372,4200
"420",20200107,32500,32700,1433,205,200
"421",20200107,43300,43500,1433,272,200
"422",20200107,73200,73400,1433,450,200
"423",20200107,101000,101200,1433,607,200
"424",20200107,115900,120100,1433,715,4200
"425",20200107,165500,165700,1433,1010,200
"426",20200111,13200,13400,1433,92,200
"427",20200111,94600,94800,1433,585,200
"428",20200111,115900,120100,1433,717,4200
"429",20200111,120100,120300,1433,718,200
"430",20200111,171600,171800,1433,1032,200
"431",20200111,223100,223300,1433,1346,200
"432",20200112,13100,13300,1414,91,200
"433",20200112,21600,21800,1414,135,200
"434",20200112,30200,30400,1414,180,200
"435",20200112,60100,60300,1414,358,200
"436",20200112,73100,73300,1414,447,200
"437",20200112,115900,120100,1414,714,4200
"438",20200112,141700,141900,1414,851,200
"439",20200112,154700,154900,1414,940,200
"440",20200112,231800,233600,1414,1390,1800
"441",20200113,21600,21800,1432,136,200
"442",20200113,60100,60300,1432,360,200
"443",20200113,115900,120100,1432,717,4200
"444",20200113,124700,124900,1432,764,200
"445",20200113,171700,171900,1432,1033,200
"446",20200113,184700,184900,1432,1122,200
"447",20200113,223100,223300,1432,1345,200
"448",20200114,34700,34900,1432,227,200
"449",20200114,51700,51900,1432,316,200
"450",20200114,111700,111900,1432,675,200
"451",20200114,115900,120100,1432,716,4200
"452",20200114,171700,171900,1432,1033,200
"453",20200114,210200,210400,1432,1257,200
"454",20200114,223100,223300,1432,1345,200
"455",20200115,21800,22000,1426,138,200
"456",20200115,90100,90300,1426,540,200
"457",20200115,115900,120100,1426,717,4200
"458",20200115,141100,141400,1426,848,300
"459",20200115,141600,142100,1426,851,500
"460",20200115,154800,155000,1426,939,200
"461",20200115,163300,163500,1426,983,200
"462",20200115,193300,193500,1426,1162,200
"463",20200115,210300,210500,1426,1251,200
"464",20200116,64700,64900,1320,407,200
"465",20200116,112300,132100,1320,682,19800
"466",20200116,141700,141900,1320,739,200
"467",20200117,13100,13300,1418,91,200
"468",20200117,60200,60400,1418,361,200
"469",20200117,102800,104100,1418,626,1300
"470",20200117,115900,120100,1418,705,4200
"471",20200117,163200,163400,1418,977,200
"472",20200117,180200,180400,1418,1066,200
"473",20200117,193100,193400,1418,1154,300
"474",20200117,210200,210400,1418,1243,200
"475",20200117,223200,223400,1418,1332,200
"476",20200124,115900,120100,1222,719,4200
"477",20200124,135000,172600,1222,829,37600
"478",20200124,211500,211700,1222,1059,200
"479",20200125,900,1100,1435,9,200
"480",20200125,14500,14700,1435,104,200
"481",20200125,31500,31700,1435,193,200
"482",20200125,115900,120100,1435,716,4200
"483",20200126,115900,120100,1438,719,4200
"484",20200127,115900,120100,1437,719,4200
"485",20200127,125900,130100,1437,778,4200
"486",20200128,115900,120100,1438,719,4200
"487",20200129,115900,120100,1438,719,4200
"488",20200130,115900,120100,1438,719,4200
"489",20200131,115900,120100,1412,719,4200
"490",20200131,140800,143500,1412,847,2700
"491",20200201,115900,120100,1438,719,4200
"492",20200202,115900,120100,1438,719,4200
"493",20200203,115900,120100,1438,719,4200
"494",20200204,115900,120100,1438,719,4200
"495",20200205,115900,120100,1438,719,4200
"496",20200206,115900,120100,1438,719,4200
"497",20200207,115900,120100,1438,719,4200
"498",20200211,100,300,1321,1,200
"499",20200211,300,500,1321,2,200
"500",20200211,43200,43400,1321,270,200
"501",20200211,51700,51900,1321,314,200
"502",20200211,60300,60500,1321,359,200
"503",20200211,82600,101700,1321,501,19100
"504",20200211,103200,103400,1321,517,200
"505",20200211,115900,120100,1321,603,4200
"506",20200211,120100,120300,1321,604,200
"507",20200212,4800,5000,1365,48,200
"508",20200212,101800,112200,1365,617,10400
"509",20200212,115900,120100,1365,655,4200
"510",20200212,124700,124900,1365,702,200
"511",20200212,131000,131500,1365,724,500
"512",20200212,141600,141800,1365,786,200
"513",20200212,154700,154900,1365,876,200
"514",20200212,180200,180400,1365,1010,200
"515",20200212,210300,210500,1365,1190,200
"516",20200213,30100,30300,1352,181,200
"517",20200213,43200,43400,1352,271,200
"518",20200213,84600,100900,1352,524,16300
"519",20200213,103100,103300,1352,547,200
"520",20200213,115900,120100,1352,634,4200
"521",20200213,232900,233100,1352,1323,200
"522",20200214,115900,120100,1432,719,4200
"523",20200214,150400,150800,1432,903,400
"524",20200214,150800,151000,1432,904,200
"525",20200214,162300,162500,1432,978,200
"526",20200214,205200,205400,1432,1246,200
"527",20200218,42600,42800,1403,266,200
"528",20200218,55600,55800,1403,355,200
"529",20200218,102600,102800,1403,624,200
"530",20200218,111900,113700,1403,676,1800
"531",20200218,115900,120100,1403,699,4200
"532",20200218,124100,124300,1403,740,200
"533",20200218,171000,172200,1403,1008,1200
"534",20200218,180200,180500,1403,1049,300
"535",20200218,215200,215400,1403,1277,200
"536",20200222,94500,94700,1433,585,200
"537",20200222,111500,111700,1433,674,200
"538",20200222,115900,120100,1433,717,4200
"539",20200222,193000,193200,1433,1167,200
"540",20200222,214500,214700,1433,1301,200
"541",20200222,231500,231700,1433,1390,200
"542",20200223,4500,4700,1434,45,200
"543",20200223,94500,94700,1434,584,200
"544",20200223,115900,120100,1434,717,4200
"545",20200223,133000,133200,1434,807,200
"546",20200223,214500,214700,1434,1301,200
"547",20200224,34500,34700,1434,225,200
"548",20200224,103000,103200,1434,629,200
"549",20200224,115900,120100,1434,717,4200
"550",20200224,171500,171700,1434,1032,200
"551",20200224,193000,193200,1434,1166,200
"552",20200225,13000,13200,1431,90,200
"553",20200225,34400,34600,1431,223,200
"554",20200225,51500,51700,1431,313,200
"555",20200225,81500,81700,1431,492,200
"556",20200225,115900,120100,1431,715,4200
"557",20200225,184500,184700,1431,1120,200
"558",20200225,201500,201700,1431,1209,200
"559",20200225,223000,223200,1431,1343,200
"560",20200226,4500,4700,1423,45,200
"561",20200226,21500,21700,1423,134,200
"562",20200226,51500,51700,1423,313,200
"563",20200226,75500,80200,1423,472,4700
"564",20200226,80200,80800,1423,473,600
"565",20200226,80800,81000,1423,474,200
"566",20200226,115900,120100,1423,704,4200
"567",20200227,13800,14000,1435,98,200
"568",20200227,60800,61000,1435,367,200
"569",20200227,115900,120100,1435,717,4200
"570",20200227,195900,200100,1435,1196,4200
"571",20200228,41400,41600,1432,254,200
"572",20200228,84400,84600,1432,523,200
"573",20200228,115900,120100,1432,717,4200
"574",20200228,161400,161600,1432,971,200
"575",20200228,195900,200100,1432,1195,4200
"576",20200228,204400,204600,1432,1239,200
"577",20200228,221400,221600,1432,1328,200
"578",20200229,75900,80100,1286,479,4200
"579",20200229,115900,120100,1286,718,4200
"580",20200229,122900,123100,1286,747,200
"581",20200229,182900,183100,1286,1106,200
"582",20200303,31800,32000,1431,198,200
"583",20200303,40400,40600,1431,243,200
"584",20200303,100400,100600,1431,602,200
"585",20200303,115900,120100,1431,716,4200
"586",20200303,121800,122000,1431,734,200
"587",20200303,160400,160600,1431,959,200
"588",20200303,164900,165100,1431,1003,200
"589",20200303,220400,220600,1431,1317,200
"590",20200304,115900,120100,1435,719,4200
"591",20200304,143300,143500,1435,872,200
"592",20200304,165000,165200,1435,1008,200
"593",20200304,212000,212200,1435,1277,200
"594",20200305,40300,40500,1281,243,200
"595",20200305,53200,80600,1281,331,27400
"596",20200305,80600,80800,1281,332,200
"597",20200305,115900,120100,1281,564,4200
"598",20200305,123500,123700,1281,599,200
"599",20200305,183600,183800,1281,959,200
"600",20200306,50600,50800,1433,306,200
"601",20200306,85000,85200,1433,529,200
"602",20200306,115900,120100,1433,717,4200
"603",20200306,132100,132300,1433,798,200
"604",20200306,192100,192300,1433,1157,200
"605",20200306,213600,213800,1433,1291,200
"606",20200307,50600,50800,1434,306,200
"607",20200307,115100,115300,1434,710,200
"608",20200307,115900,120100,1434,717,4200
"609",20200307,140600,140800,1434,843,200
"610",20200307,230600,230800,1434,1382,200
"611",20200308,3500,3700,1432,35,200
"612",20200308,42100,42300,1432,260,200
"613",20200308,72100,72300,1432,439,200
"614",20200308,102100,102300,1432,618,200
"615",20200308,115900,120100,1432,715,4200
"616",20200308,175100,175300,1432,1066,200
"617",20200308,223000,223200,1432,1344,200
"618",20200309,43000,43200,1433,270,200
"619",20200309,55200,55400,1433,351,200
"620",20200309,102100,102300,1433,619,200
"621",20200309,110600,110800,1433,663,200
"622",20200309,115900,120100,1433,715,4200
"623",20200309,184200,184400,1433,1117,200
"624",20200310,33700,33900,1430,217,200
"625",20200310,42200,42400,1430,261,200
"626",20200310,55100,55300,1430,349,200
"627",20200310,114300,114500,1430,700,200
"628",20200310,115900,120100,1430,715,4200
"629",20200310,123600,123800,1430,751,200
"630",20200310,192000,192200,1430,1154,200
"631",20200310,200600,200800,1430,1199,200
"632",20200310,222000,222200,1430,1332,200
"633",20200311,3600,3800,1430,36,200
"634",20200311,63600,63800,1430,395,200
"635",20200311,72000,72200,1430,438,200
"636",20200311,80600,80800,1430,483,200
"637",20200311,93500,93700,1430,571,200
"638",20200311,115900,120100,1430,714,4200
"639",20200311,140600,140800,1430,840,200
"640",20200311,153600,153800,1430,929,200
"641",20200311,154500,154700,1430,937,200
"642",20200312,4500,4700,1423,45,200
"643",20200312,12000,12200,1423,79,200
"644",20200312,20500,20800,1423,123,300
"645",20200312,25000,25200,1423,166,200
"646",20200312,55000,55200,1423,345,200
"647",20200312,80600,80800,1423,480,200
"648",20200312,93600,93800,1423,569,200
"649",20200312,110600,110800,1423,658,200
"650",20200312,115900,120100,1423,710,4200
"651",20200312,132100,132300,1423,791,200
"652",20200312,175100,175300,1423,1060,200
"653",20200312,192100,192300,1423,1149,200
"654",20200312,195500,195700,1423,1182,200
"655",20200312,222100,222300,1423,1327,200
"656",20200312,230600,230800,1423,1371,200
"657",20200314,3600,3800,1427,36,200
"658",20200314,4500,4700,1427,44,200
"659",20200314,11400,11600,1427,72,200
"660",20200314,15500,15700,1427,112,200
"661",20200314,73000,73200,1427,446,200
"662",20200314,115900,120100,1427,714,4200
"663",20200314,122500,122700,1427,739,200
"664",20200314,124500,124700,1427,758,200
"665",20200314,165500,165700,1427,1007,200
"666",20200314,183600,183800,1427,1107,200
"667",20200314,183900,184100,1427,1109,200
"668",20200314,192900,193100,1427,1158,200
"669",20200315,13000,13200,1430,90,200
"670",20200315,33600,33800,1430,215,200
"671",20200315,45500,45700,1430,293,200
"672",20200315,54000,54200,1430,337,200
"673",20200315,72100,72300,1430,437,200
"674",20200315,84000,84200,1430,515,200
"675",20200315,94400,94600,1430,578,200
"676",20200315,115900,120100,1430,712,4200
"677",20200315,212600,212800,1430,1278,200
"678",20200316,13000,13200,1430,90,200
"679",20200316,55100,55300,1430,350,200
"680",20200316,75900,80100,1430,477,4200
"681",20200316,93600,93800,1430,573,200
"682",20200316,115900,120100,1430,715,4200
"683",20200316,123600,123800,1430,751,200
"684",20200316,140600,140800,1430,840,200
"685",20200316,145100,145300,1430,884,200
"686",20200316,183600,183800,1430,1108,200
"687",20200317,13100,13300,1427,91,200
"688",20200317,51500,51700,1427,314,200
"689",20200317,61100,61300,1427,369,200
"690",20200317,61600,61800,1427,373,200
"691",20200317,64600,64800,1427,402,200
"692",20200317,82500,82700,1427,500,200
"693",20200317,90000,90200,1427,534,200
"694",20200317,115900,120100,1427,712,4200
"695",20200317,163000,163300,1427,982,300
"696",20200317,180000,180200,1427,1070,200
"697",20200317,231600,231800,1427,1385,200
"698",20200318,12100,12300,1434,81,200
"699",20200318,43100,43300,1434,270,200
"700",20200318,102100,102300,1434,619,200
"701",20200318,115900,120200,1434,716,4300
