"","dia","hora","hora_1","amostras","linha","diferenca"
"amostras_faltantes_aux",20191004,32500,32700,1437,205,200
"amostras_faltantes_aux",20191004,42700,42900,1437,266,200
"amostras_faltantes_aux",20191005,10600,10800,1436,66,200
"amostras_faltantes_aux",20191005,22400,22600,1436,143,200
"amostras_faltantes_aux",20191005,43900,44100,1436,277,200
"amostras_faltantes_aux",20191014,105000,110700,1421,650,5700
"amostras_faltantes_aux",20191014,170000,170300,1421,1004,300
"amostras_faltantes_aux",20191015,300,500,1384,3,200
"amostras_faltantes_aux",20191015,4900,5200,1384,48,300
"amostras_faltantes_aux",20191015,30400,30600,1384,181,200
"amostras_faltantes_aux",20191015,83400,83600,1384,510,200
"amostras_faltantes_aux",20191015,90400,90700,1384,539,300
"amostras_faltantes_aux",20191015,91900,92200,1384,552,300
"amostras_faltantes_aux",20191015,110000,114300,1384,651,4300
"amostras_faltantes_aux",20191015,124700,124900,1384,716,200
"amostras_faltantes_aux",20191015,153800,154100,1384,886,300
"amostras_faltantes_aux",20191015,155100,155300,1384,897,200
"amostras_faltantes_aux",20191016,400,700,1385,4,300
"amostras_faltantes_aux",20191016,101000,101200,1385,610,200
"amostras_faltantes_aux",20191016,110600,113000,1385,665,2400
"amostras_faltantes_aux",20191016,152700,152900,1385,903,200
"amostras_faltantes_aux",20191016,152900,153100,1385,904,200
"amostras_faltantes_aux",20191016,153100,153500,1385,905,400
"amostras_faltantes_aux",20191016,155800,160400,1385,929,4600
"amostras_faltantes_aux",20191016,165400,170000,1385,980,4600
"amostras_faltantes_aux",20191016,171000,172000,1385,991,1000
"amostras_faltantes_aux",20191016,172200,172900,1385,994,700
"amostras_faltantes_aux",20191018,100300,100500,1431,604,200
"amostras_faltantes_aux",20191018,122300,123100,1431,743,800
"amostras_faltantes_aux",20191018,130100,130300,1431,774,200
"amostras_faltantes_aux",20191020,143900,144100,1379,820,200
"amostras_faltantes_aux",20191021,5900,61000,1128,60,55100
"amostras_faltantes_aux",20191021,91300,91500,1128,244,200
"amostras_faltantes_aux",20191021,91700,91900,1128,247,200
"amostras_faltantes_aux",20191024,30400,30600,1438,184,200
"amostras_faltantes_aux",20191025,44500,44900,1437,286,400
"amostras_faltantes_aux",20191029,172100,172300,1438,1041,200
"amostras_faltantes_aux",20191031,30600,30800,1437,186,200
"amostras_faltantes_aux",20191031,175900,180100,1437,1078,4200
"amostras_faltantes_aux",20191101,4400,4600,1437,44,200
"amostras_faltantes_aux",20191101,34400,34600,1437,223,200
"amostras_faltantes_aux",20191104,25900,30100,1438,180,4200
"amostras_faltantes_aux",20191104,31200,31400,1438,192,200
"amostras_faltantes_aux",20191105,44200,44400,1439,283,200
"amostras_faltantes_aux",20191106,21400,21600,1437,135,200
"amostras_faltantes_aux",20191106,22700,22900,1437,147,200
"amostras_faltantes_aux",20191106,34400,34600,1437,223,200
"amostras_faltantes_aux",20191107,154200,161200,1411,943,7000
"amostras_faltantes_aux",20191108,31200,31400,1439,193,200
"amostras_faltantes_aux",20191109,35700,35900,1438,238,200
"amostras_faltantes_aux",20191109,122000,122200,1438,740,200
"amostras_faltantes_aux",20191111,14200,14400,1438,103,200
"amostras_faltantes_aux",20191111,25900,30100,1438,179,4200
"amostras_faltantes_aux",20191114,25900,30100,1439,180,4200
"amostras_faltantes_aux",20191118,85600,90800,1412,537,5200
"amostras_faltantes_aux",20191118,92800,94600,1412,558,1800
"amostras_faltantes_aux",20191121,10100,10300,1248,62,200
"amostras_faltantes_aux",20191124,50000,50200,1439,301,200
"amostras_faltantes_aux",20191125,11500,11700,1438,76,200
"amostras_faltantes_aux",20191125,41500,41700,1438,255,200
"amostras_faltantes_aux",20191126,33000,33200,1439,211,200
"amostras_faltantes_aux",20191127,32100,32300,1438,202,200
"amostras_faltantes_aux",20191127,41500,41700,1438,255,200
"amostras_faltantes_aux",20191128,15100,15400,1437,112,300
"amostras_faltantes_aux",20191128,41500,41700,1437,254,200
"amostras_faltantes_aux",20191129,110300,110500,1418,664,200
"amostras_faltantes_aux",20191129,154300,160200,1418,943,5900
"amostras_faltantes_aux",20191129,160200,160400,1418,944,200
"amostras_faltantes_aux",20191129,194900,195100,1418,1170,200
"amostras_faltantes_aux",20191129,220300,220500,1418,1303,200
"amostras_faltantes_aux",20191130,14800,15000,1100,108,200
"amostras_faltantes_aux",20191130,31200,31400,1100,191,200
"amostras_faltantes_aux",20191130,44500,44700,1100,283,200
"amostras_faltantes_aux",20191130,72100,125800,1100,438,53700
"amostras_faltantes_aux",20191201,11200,11400,1308,73,200
"amostras_faltantes_aux",20191201,24200,45400,1308,162,21200
"amostras_faltantes_aux",20191202,5700,45000,1199,58,39300
"amostras_faltantes_aux",20191202,92500,92800,1199,334,300
"amostras_faltantes_aux",20191202,172100,172900,1199,808,800
"amostras_faltantes_aux",20191204,235900,307800,1463,1440,71900
"amostras_faltantes_aux",20191204,307900,314000,1463,1442,6100
"amostras_faltantes_aux",20191204,315900,378500,1463,1462,62600
"amostras_faltantes_aux",20191206,5700,51800,1180,58,46100
"amostras_faltantes_aux",20191207,5700,45000,1231,58,39300
"amostras_faltantes_aux",20191207,235900,307800,1231,1208,71900
"amostras_faltantes_aux",20191207,307900,314000,1231,1210,6100
"amostras_faltantes_aux",20191207,315900,378500,1231,1230,62600
"amostras_faltantes_aux",20191208,5700,10000,1218,58,4300
"amostras_faltantes_aux",20191208,11100,45200,1218,70,34100
"amostras_faltantes_aux",20191209,10000,10200,1438,61,200
"amostras_faltantes_aux",20191209,42600,42800,1438,266,200
"amostras_faltantes_aux",20191210,10000,115800,783,61,105800
"amostras_faltantes_aux",20191211,100300,100500,1448,604,200
"amostras_faltantes_aux",20191211,184200,184800,1448,1122,600
"amostras_faltantes_aux",20191211,190600,191100,1448,1141,500
"amostras_faltantes_aux",20191211,192400,193000,1448,1155,600
"amostras_faltantes_aux",20191211,235900,307800,1448,1425,71900
"amostras_faltantes_aux",20191211,307900,314000,1448,1427,6100
"amostras_faltantes_aux",20191211,315900,378500,1448,1447,62600
"amostras_faltantes_aux",20191212,5700,45500,521,58,39800
"amostras_faltantes_aux",20191212,123300,123600,521,517,300
"amostras_faltantes_aux",20191213,153200,153400,315,122,200
"amostras_faltantes_aux",20191214,35800,40000,1185,181,4200
"amostras_faltantes_aux",20191214,44300,44500,1185,225,200
"amostras_faltantes_aux",20191214,131900,163500,1185,740,31600
"amostras_faltantes_aux",20191215,5700,45600,1195,58,39900
"amostras_faltantes_aux",20191215,123000,123200,1195,513,200
"amostras_faltantes_aux",20191215,193500,194200,1195,937,700
"amostras_faltantes_aux",20191216,5700,45600,1194,58,39900
"amostras_faltantes_aux",20191216,111000,111200,1194,433,200
"amostras_faltantes_aux",20191216,153800,154600,1194,700,800
"amostras_faltantes_aux",20191217,5700,50400,1191,58,44700
"amostras_faltantes_aux",20191217,122300,122500,1191,498,200
"amostras_faltantes_aux",20191217,122500,122800,1191,499,300
"amostras_faltantes_aux",20191218,111500,111700,1439,676,200
"amostras_faltantes_aux",20191219,115900,120100,1439,720,4200
"amostras_faltantes_aux",20191220,10100,10300,1438,62,200
"amostras_faltantes_aux",20191220,40200,40400,1438,242,200
"amostras_faltantes_aux",20191221,15700,15900,1437,118,200
"amostras_faltantes_aux",20191221,32700,32900,1437,207,200
"amostras_faltantes_aux",20191221,40100,40300,1437,240,200
"amostras_faltantes_aux",20191222,24200,24400,1439,163,200
"amostras_faltantes_aux",20191225,32700,32900,992,208,200
"amostras_faltantes_aux",20191226,44700,44900,1319,228,200
"amostras_faltantes_aux",20191226,125600,135700,1319,716,10100
"amostras_faltantes_aux",20191227,5600,5800,1438,57,200
"amostras_faltantes_aux",20191227,125600,125800,1438,776,200
"amostras_faltantes_aux",20191228,5600,50500,1178,57,44900
"amostras_faltantes_aux",20191228,125600,125800,1178,529,200
"amostras_faltantes_aux",20191228,164000,165400,1178,752,1400
"amostras_faltantes_aux",20191229,5600,50000,1196,57,44400
"amostras_faltantes_aux",20191229,125600,125800,1196,534,200
"amostras_faltantes_aux",20191230,5600,50400,1197,57,44800
"amostras_faltantes_aux",20191231,5600,50100,1196,57,44500
"amostras_faltantes_aux",20200101,5600,50200,1195,57,44600
"amostras_faltantes_aux",20200102,5600,45900,1196,57,40300
"amostras_faltantes_aux",20200102,105700,110000,1196,416,4300
"amostras_faltantes_aux",20200103,5600,50400,1192,57,44800
"amostras_faltantes_aux",20200103,114200,114400,1192,456,200
"amostras_faltantes_aux",20200104,5600,50200,1195,57,44600
"amostras_faltantes_aux",20200105,5600,50500,1192,57,44900
"amostras_faltantes_aux",20200108,111800,112000,1437,679,200
"amostras_faltantes_aux",20200108,112300,112500,1437,683,200
"amostras_faltantes_aux",20200108,114100,114300,1437,700,200
"amostras_faltantes_aux",20200109,5600,50900,341,57,45300
"amostras_faltantes_aux",20200109,74600,92100,341,215,17500
"amostras_faltantes_aux",20200109,105500,110800,341,310,5300
"amostras_faltantes_aux",20200109,112500,113100,341,328,600
"amostras_faltantes_aux",20200110,75900,81500,708,14,5600
"amostras_faltantes_aux",20200110,82300,82500,708,23,200
"amostras_faltantes_aux",20200110,82500,82700,708,24,200
"amostras_faltantes_aux",20200110,82800,83000,708,26,200
"amostras_faltantes_aux",20200110,84000,84200,708,37,200
"amostras_faltantes_aux",20200110,84300,84500,708,39,200
"amostras_faltantes_aux",20200110,85600,85800,708,51,200
"amostras_faltantes_aux",20200110,85900,91800,708,53,5900
"amostras_faltantes_aux",20200110,95600,95800,708,92,200
"amostras_faltantes_aux",20200110,100900,101100,708,104,200
"amostras_faltantes_aux",20200110,101700,102100,708,111,400
"amostras_faltantes_aux",20200110,102100,102300,708,112,200
"amostras_faltantes_aux",20200110,103300,105400,708,123,2100
"amostras_faltantes_aux",20200110,105500,105700,708,125,200
"amostras_faltantes_aux",20200110,113500,131800,708,164,18300
"amostras_faltantes_aux",20200110,170800,184700,708,395,13900
"amostras_faltantes_aux",20200112,231800,233400,1425,1399,1600
"amostras_faltantes_aux",20200113,21600,21800,1439,137,200
"amostras_faltantes_aux",20200114,34700,34900,1439,228,200
"amostras_faltantes_aux",20200115,141600,141800,1440,858,200
"amostras_faltantes_aux",20200116,112300,131800,1326,684,19500
"amostras_faltantes_aux",20200117,13100,13300,1431,92,200
"amostras_faltantes_aux",20200117,102800,103700,1431,628,900
"amostras_faltantes_aux",20200118,5600,51400,861,57,45800
"amostras_faltantes_aux",20200118,73500,73700,861,199,200
"amostras_faltantes_aux",20200118,80200,82300,861,225,2100
"amostras_faltantes_aux",20200118,84200,90300,861,245,6100
"amostras_faltantes_aux",20200118,92600,125700,861,269,33100
"amostras_faltantes_aux",20200119,121600,121800,1382,680,200
"amostras_faltantes_aux",20200120,5600,51300,1182,57,45700
"amostras_faltantes_aux",20200120,121800,122000,1182,483,200
"amostras_faltantes_aux",20200120,145800,150000,1182,642,4200
"amostras_faltantes_aux",20200121,5600,51000,1183,57,45400
"amostras_faltantes_aux",20200121,60800,61000,1183,116,200
"amostras_faltantes_aux",20200121,145100,145300,1183,638,200
"amostras_faltantes_aux",20200121,175500,175700,1183,821,200
"amostras_faltantes_aux",20200121,191000,191200,1183,895,200
"amostras_faltantes_aux",20200122,4600,4800,1099,47,200
"amostras_faltantes_aux",20200122,5600,63500,1099,56,57900
"amostras_faltantes_aux",20200122,63600,63800,1099,58,200
"amostras_faltantes_aux",20200122,113000,113200,1099,351,200
"amostras_faltantes_aux",20200123,5600,5800,1436,57,200
"amostras_faltantes_aux",20200123,95100,95300,1436,591,200
"amostras_faltantes_aux",20200123,124300,124500,1436,762,200
"amostras_faltantes_aux",20200123,124500,124700,1436,763,200
"amostras_faltantes_aux",20200124,135000,135200,1439,831,200
"amostras_faltantes_aux",20200125,14500,14700,1438,106,200
"amostras_faltantes_aux",20200125,31500,31700,1438,195,200
"amostras_faltantes_aux",20200131,140800,143100,1418,849,2300
"amostras_faltantes_aux",20200208,52700,55200,1416,328,2500
"amostras_faltantes_aux",20200209,5500,52600,1166,56,47100
"amostras_faltantes_aux",20200209,105300,105600,1166,384,300
"amostras_faltantes_aux",20200209,124600,124800,1166,495,200
"amostras_faltantes_aux",20200209,125400,125600,1166,502,200
"amostras_faltantes_aux",20200210,5500,52800,1158,56,47300
"amostras_faltantes_aux",20200210,110000,110300,1158,389,300
"amostras_faltantes_aux",20200210,120900,121100,1158,456,200
"amostras_faltantes_aux",20200210,122100,122300,1158,467,200
"amostras_faltantes_aux",20200210,143900,144600,1158,604,700
"amostras_faltantes_aux",20200211,43200,43400,1438,273,200
"amostras_faltantes_aux",20200211,51700,51900,1438,317,200
"amostras_faltantes_aux",20200213,30100,30300,1438,182,200
"amostras_faltantes_aux",20200213,43200,43400,1438,272,200
"amostras_faltantes_aux",20200215,5500,53100,1165,56,47600
"amostras_faltantes_aux",20200216,102200,102400,1169,354,200
"amostras_faltantes_aux",20200216,235500,235700,1169,1166,200
"amostras_faltantes_aux",20200217,63400,64000,1414,395,600
"amostras_faltantes_aux",20200217,64900,65500,1414,405,600
"amostras_faltantes_aux",20200217,65900,70400,1414,410,4500
"amostras_faltantes_aux",20200217,70800,71400,1414,415,600
"amostras_faltantes_aux",20200217,71700,72300,1414,419,600
"amostras_faltantes_aux",20200217,72900,73200,1414,426,300
"amostras_faltantes_aux",20200218,102600,102800,1438,626,200
"amostras_faltantes_aux",20200219,95200,95400,1432,592,200
"amostras_faltantes_aux",20200219,155900,160600,1432,958,4700
"amostras_faltantes_aux",20200220,5900,53700,969,60,47800
"amostras_faltantes_aux",20200220,125800,130000,969,502,4200
"amostras_faltantes_aux",20200221,125800,130000,1097,437,4200
"amostras_faltantes_aux",20200224,34500,34700,1439,226,200
"amostras_faltantes_aux",20200225,13000,13200,1437,91,200
"amostras_faltantes_aux",20200225,34400,34600,1437,224,200
"amostras_faltantes_aux",20200225,51500,51700,1437,314,200
"amostras_faltantes_aux",20200226,21500,21700,1427,136,200
"amostras_faltantes_aux",20200226,51500,51700,1427,315,200
"amostras_faltantes_aux",20200226,75500,80200,1427,474,4700
"amostras_faltantes_aux",20200226,80200,80800,1427,475,600
"amostras_faltantes_aux",20200227,13800,14000,1439,99,200
"amostras_faltantes_aux",20200228,41400,41600,1439,255,200
"amostras_faltantes_aux",20200229,213000,213500,1436,1291,500
"amostras_faltantes_aux",20200301,5800,53700,1162,59,47900
"amostras_faltantes_aux",20200302,5800,53800,1151,59,48000
"amostras_faltantes_aux",20200302,95300,95500,1151,315,200
"amostras_faltantes_aux",20200302,102100,102300,1151,342,200
"amostras_faltantes_aux",20200302,103600,103800,1151,356,200
"amostras_faltantes_aux",20200302,103900,104100,1151,358,200
"amostras_faltantes_aux",20200302,111700,111900,1151,395,200
"amostras_faltantes_aux",20200302,112500,112700,1151,402,200
"amostras_faltantes_aux",20200302,115600,115800,1151,432,200
"amostras_faltantes_aux",20200302,115800,120200,1151,433,4400
"amostras_faltantes_aux",20200303,31800,32000,1438,199,200
"amostras_faltantes_aux",20200303,40400,40600,1438,244,200
"amostras_faltantes_aux",20200305,40300,40500,1432,244,200
"amostras_faltantes_aux",20200305,53200,53900,1432,332,700
"amostras_faltantes_aux",20200305,55700,55900,1432,351,200
"amostras_faltantes_aux",20200306,50600,50800,1439,307,200
"amostras_faltantes_aux",20200307,50600,50800,1439,307,200
"amostras_faltantes_aux",20200308,42100,42300,1439,262,200
"amostras_faltantes_aux",20200309,43000,43200,1438,270,200
"amostras_faltantes_aux",20200310,33700,33900,1437,217,200
"amostras_faltantes_aux",20200310,42200,42400,1437,261,200
"amostras_faltantes_aux",20200311,3600,3800,1438,36,200
"amostras_faltantes_aux",20200312,4500,4700,1434,45,200
"amostras_faltantes_aux",20200312,12000,12200,1434,79,200
"amostras_faltantes_aux",20200312,20500,20800,1434,123,300
"amostras_faltantes_aux",20200312,25000,25200,1434,166,200
"amostras_faltantes_aux",20200313,12100,12300,870,81,200
"amostras_faltantes_aux",20200313,21600,21900,870,135,300
"amostras_faltantes_aux",20200313,23200,115900,870,149,92700
"amostras_faltantes_aux",20200316,13000,13200,1437,90,200
"amostras_faltantes_aux",20200316,183600,183800,1437,1115,200
"amostras_faltantes_aux",20200317,13100,13300,1437,91,200
"amostras_faltantes_aux",20200317,51500,51700,1437,314,200
